++++++++++++
+++   +++T++
++     ++ ++
++ + +++   +
+++ +  +++ +
+++ +++ ++ +
+          +
++++S++++  +
++++   ++  +
++ + + ++ ++
+ ++ ++++  +
+ ++ +++ + +
+ ++++   +  
+ +++  + +++
++      T+++
++++++++++++
