+ + + + + + + + + + + +
+ + +       + + + T + +
+ +           + +   + +
+ +   +   + + +       +
+ + +   +     + + +   +
+ + +   + + +   + +   +
+                     +
+ + + + S + + + +     +
+ + + +       + +     +
+ +   +   +   + +   + +
+   + +   + + + +     +
+   + +   + + +   +   +
+   + + + + +          
+   + + +     +   + + +
+ +             T + + +
+ + + + + + + + + + + +
